WWWWWWWWWW
W   F    W
WWWWWWW  W
WGGB     W
WGG WWWWWW
WGG     KW
WGG     MW
W WWWWWWWW
Wk       D
WWWWWWWWWW
