WWWWWWWWWW
W        W
W        O
W        W
W        W
W        W
W        W
W        W
W        W
WWWWWWWWWW
